000000000000000
011111111111110
010010000000C10
010000111110010
01P0011E0000010
011111111111110
000000000000000