1111111111111
1001000000011
1000011111001
1P0011E000C01
1111111111111