1111111111111
100100000P0C1
10P0011111001
100011E000001
1111111111111