11111111111
10000C00001
1C101100001
1000000E101
10000011101
1P000000C01
11111111111
