11111111111
10000C00001
1C101111101
1010000E101
10000000111
1P000000C01
11111111111