11111111111
10000000001
10101111101
1010000E101
10111111101
1P000000C01
11111111111